Side A
..##############################################################################################
################################################################################################
################################################################################################
################################################################################################
################################################.###############################################
#######################################..#.#....##....#...######################################
######################################.###########..#.###..#####################################
##################################.#....##.#.....#.....#.###.#.#################################
##################################...#...##..#.#.###...#...#.#...#.#############################
#############################.##.##..#...##.######.#.#.##..#..#....#.###########################
##########################..#.#.......###..#.###.#..##.....##.#..##..###########################
#########################.###...##...###.##.#.##.#.####.#.#.##..#...#..#########################
#########################.#..#.###.#.#..#####..##...#..#.....#.......##.########################
###########################..#.#...#.##.##.....####.#....##.#..#.##...###.######################
#####################.#.#.#.#.............#.#.#.###..#...######..#......#.######################
###################..##.#..#.##.##..#.##.#.#.####..#.#......###.####....###.#.##################
#####################.##.##..##.##.#..######..#.#..#....#..#.#.######..##.##.#.#################
###################...#.##.#####.#...#.#...#...#..#####.#....##.....#.#..##.#.##################
################.....#.###...###.##.#..##..#@....######...####..#.###..##..##.#..###############
################.##..###.#..#........#..#...@.#.##.#.#.#.....#@@@@@.#.####....###.##############
################.##.#...#.#.##.......#..#...@...#..#.##.##....@..##.#.##...#.##...##############
#################.###..#.##.#.#....#.#.....#@......@......@@@@##...#..#######.##..##############
#############....##.##.#...##.###.##.#.....#@####.#@###.#...#@####.####....##...################
############...#...#..##.##....#..#........#@.###..@##.#.....@#.##.###.###.#...#..#.############
##############.##.#..#..#.##.#...###...#.#..@##..#.@#.#......@#..####.#..#.....####..###########
###########..#.#..##.##..#.#..####.#.#......@#####.@.#.......@#..............#.#.####.##########
##########.....######....#.#....##.....##...@..#.#.@.####.#.#@.####.###..#.#..#.#.###.##########
##########.....###.#####.##.#...#...#.######@#.##..@#.######.@.#####.#..#.####.#.#.##..#########
#########.#..#.#.#..##.#.....#..####.#..#.#.@#.#...@.....#...@...#.##.###.......#.#..###########
#########.##.##.########@@@@@@@@@@@@@@@@@..#@##.###@..#....####.##.#..#.###......#.#..##########
########.###.##...##..#...#.##.###@##...@...@@@@@@@@##..#.#.####..##..#####.####.##.###.########
#########.#..##.###.......###..##.@#..##@.######...@.#.#.#....#........#.#########.....#########
########.##.#...###..#..#####...#.@....#@##.####.##@.#.##..#.####@.#...#.#......#.#....#.#######
########.#####..#....#.##.##.#####@#.#..@.#.###.###@@@@@@@@@@@@@@@@#.#.##.#....###.####..#######
#########.#.#......##....#.###.#.#@#.#..@....###.#.@##.#....##.##@####.#.#...##...###..##.######
######@@@@@@@@@@@@@@@@@##.#.###.##@#.###@.##.###.##@....##...#.##@#.##.#.##.###.######.##.######
######@####...#..#.........#..####@...##@###..#####@#..#.#.#.#.#.@.#....##.#.#.#.##.#.##..######
######@#..####.##....#..##.##.##..@...@#@@@@@@@@@@.@.....##.#####@...#.#..#.....##.#..#.#..#####
######@....##..#.###.....#....#..#@#.#@#.#.##.###@#@#....#..#####@.#..###...####.#.....#..######
######@.....#.########...##.#.###.@...@....#.#..#@.@#..#.#.......@#.##..##.##..##...#.##.#.#####
######@@@@@@@....#.###....#.#..#..@..#@...#.#.#..@.@..#.#.#.##..#@#..#####.#.....##...##########
#####.@#..#.@...###....#....##.##.@#.#@..##.####.@#@######.#.##..@.####.#######.#.###.....######
######@.####@..#.#.#.##.##....##.##...@...####.##@####..#..##..##@#..#..######.#.##..#..###.####
######@#..##@##.#..#..#..##.#.#@@@@@@@@@@@@@@#...@.###.#..###.###@#..#.#...##..##..#####.##.####
#####.@..#.#@..##.....####....#.#.#..#@...##.#.##@#..###.#.#....#@######...###...##...##.#..####
######@..#..@.###...#..#....##.##.####@.#.##.###.@###...#.###....@..#...##.#.###.#..##.#.#..####
######@#####@@@@@.......#.#.###@##..##@####...##.@#.#.###.##.####@#...##.##.....##..#...#...####
#####.@#.###..#.@###.##.#..##.#@#.####@.#..##.###@#.#..######.#.#@##..###..###.##.#.###.#.#.####
#####.@#.###.##.@#.##.#######..@..##.#@.#...#####@###.###.#......@@@@@@@@@@@@@@#..#.##..##.#.###
#####.@..#...#..@..#...#...####@##...#@@@@@@@...#@#.###.########.#.#...##....#.....#####....####
######@...#...#.@#.##..######.#@#..#.##.#.#.@.#.#@@@@@@...###..##...#....#.#.#.##.#..##.#.#.####
#####.#...@..#..@...###....#.#.@##..#.@@@###@##.#@..#.@..##..###.#..#..###......##.....#..######
#######..#@#...#@@@@@......#...@.#.#@@@@@@@@@@@@@@####@#..#.#...#..#..##...#.#.#...########.####
#####.##.#@#..#.....@#.#.####.#@..#.@#@...##@..#.##.##@.##....#....####.#....####..####.#.#.####
#####.####@#####.#..@.###..####@.#.#@#@#....@@@@@@@@@@@#.....########...#.#####...#.###..#..####
######...##.#..#.#..@##.####.##@..#.@#@#....@#.#.@###.@.@@@@####..##..#..#..##.##.###.#...#.####
#####.#.##.#.###....@######..#.@.###@.@.#..#@####@.###@.##.@#.#.##..####.##.####.#..##.#.##.####
########.#.##.....###......#..#@#...@@@@@@@@@@@@@@###.@#.#.@#...##..#.##.##.....##.###...##.####
#######.#..#.#.#..##....#.#.##.@.@@@@@@@@@@@@###..#..#@#######.#..#.#.###..#.#.###.#.#.##.######
##########.#...###..##.#.######@##.#@.@..#..#.#######.@####..#.###########..###.###.#####.######
######@@@@@@@@@.####.###.#.#.#.@@@@@@@@@@@@@@@##.....#@@@@@@@@@@@@@##.#..##..#.#...#.####.######
######.....##.......#.#.#####.##@##.@.@.##..#@.##.####@###....####..####..#.#.#...##..##.#######
#######.##.#.#.....###..#...#..#@..#@.@.###..@####..#.@@@@@@@@@@@@@@@###.#..##...#...###..######
#######.#.#.#.###.#....#.#...##.@##.@#@#.#.#.@##....###.#####..###.....#.##.#.#.#####...########
########.##..#.##.#..#....###.#.@.##.#@...#..@##..####.#.#........#..#.###...#..##.#..#..#######
##########.##..#.#.####...##..#.@.##..@##..##@#.##.#...##..#....#.##...@.......#.###..##########
########.#####.##.#..##........#@...##@...#.#@###..#####.#.#.##.###...#@#.#.##..#.##.....#######
#########.##..###..##.##.#....#..###..@#.###.@......###.####..###..#..#@.##.##.....#.#..########
##########.#.....#...##.####.#.#....###.#.###@##..####..@@@@@@@@@@@@@@@@#..###..#.####..########
##########.......#.##.#.#...###.#...#.###.##.@..#..#.#.####..#..@##.#...#....##.##....##########
##########...#.####.###.#..@##....###..#.###.@.#.#...#.#.#.##..#@.#...#.###..##.################
###########.###...#.###.###@....#.....#....#.@#.##@@@@@@@@@@@@@@@.......#.#....#.###.###########
###############...#....##..@##..#.##.##.##.##@##.....#..###.###.#.#....##..##.....##############
############.#.#@@@@@@@@@@@@.....##.##.#.....@@@@@@@@@@@@@@@###..#.#...#..#.....#..#############
#############.#.@.######.####...##.###.#.##..#..##..##.###.....#..#..####.##.....###############
###############.@.#.#.#######.##.#.#.###.....###.#.#.#.####...#.#.#.##.#####...#.###############
###############.@#####..#########...#.#.###....##..#...#.#...##.##.#####....##..################
###############.@#..#.#...#.####.#.....#.####...#######..#..##..#..#..##.#....##..##############
################@..#.#...#...###..###.....###...#.#.....#.#.#.##.#.####.#...####################
##################.#.#.#.#####..###.##.####.#.#....##....########.###...#.#..##.################
###################.###..#...##.#####.#.#..#.##.#...####.####.##...#.##...#.####################
#####################..####.##.#..##.#..####.#....#.###..##.####...######..#.###################
######################..###...######...#######.###...##..##...##.#.##.#....#####################
########################.#..#...#..###.#.##...##..#...######.##.....##.#.#.#####################
#########################.#####......#####..#.######..#...#.#.#.#####.##.#######################
#########################.##.#.####..#.#...#..##.#.#.######.##..##.####.########################
##########################.####...#...###.#.#..##.#.##.##.##..#####..#.#########################
##############################..#..####......#.#..##.#####..###.#...############################
##############################..#..###.#.##.#####.##.#..#.##.###...#############################
#################################.#...#.###...#.######.#...#..##################################
####################################..###.#.#.###.#.#.#.#..#..##################################
##########################################.#...##.##.##...######################################
################################################################################################
################################################################################################
################################################################################################
################################################################################################
Side B
..##############################################################################################
################################################################################################
################################################################################################
################################################################################################
###############################################.################################################
######################################..##......####.##.########################################
####################################.....###...#.##.#....##..###################################
################################..####....###....########.##.#.#################################
#############################.#.###.#.#...#.#.....####.###.####..###############################
###########################.###.#######..###.##..#..###....#...#.##.############################
#########################.##...##..#######...###.###....#.#..######...##########################
########################..###...#..##.#...#......##.##.#..###.##.####.##########################
########################.#.#..#..##.#.##...#..##.####.......#.####...##..#######################
#####################..#..##..#..#.#..####.#####.........#.##.......##..#.######################
######################..###.#.##.#.###..##..#.##.###..####..#.####...##.#.######################
##################...##.#.##...########.##...#..#..###.#....##.#.#...###.#...###################
#################.#..#.##.##...#......####..##...#....##......#....#.#.##.##.###################
################..#...##.##......#.#.##.##.###..###....#.....#####.##.#.#...####################
###############..####..##.##.#..#..###......@.####..##.##....###..#...#.#..#.###################
##############.#..##..#.#..#......#......###@#..##...##.#..#...#.#.#.#...#..###.################
##############.....######.#....#.@.#.......#@.###.####.#.......##.#.#.#........#.###############
##############..##....###.#..###.@#.#@@@@@@@@@@#..#....##..#.###....##..#.....###.##############
############.#...#.#.#.....###..#@.#....#...##@..####.#.....##..##.##...#.....#..###############
#############.##.####.######..#.#@....#....#..@##.#.#..#.##.#.#..##..##..##.....#...############
###############...##...#.#.#.####@....###..###@###..#.....#####.#####.#...##.#...##.############
##########......#...##.##..##.###@###..#.##...@.##..#.#.#...##.##.......##.##.#..##.############
##########..##....#.#####..###...@#...#.######@##.#####..#...@....#.#.#....#.##..#.#############
#########.#.##.###..#.#.#..#..#.#@.##.#####..#@..####..#.##.#@##....##.####...#.#.....##########
########.##.....#..#.#.#..####.#.@@..###...###@#.######..#...@....#...###..#.#.###....##########
########.#....#...#.#....#...#.##@@###.#.#.#..@###..##.######@#..##.##.#......#..#..#..#########
########..#####...###.#.##...#.#.@@...##.#...#@#.#.##.#..#..####.#...#...#..##..######.#########
#######..#....###....##.#.##.#..#@@##.#..#..##@#.##...#.#.#...##.#####...########....##.########
#########.##.#####.###.#.###..###@@..##....###@.###.#####.#.#.#.#@.......#......#.......########
#######.#..#.#.####....#..#@@@#.#@@##.##......@#..####...#.##.#..@....#.#.#..#.##....#...#######
######.#..#...###..###.#.#...###.@@.##..#.#.##@.#...#...####..#..@....#.####.##.#.#.#..#########
#####.#....#..#.#####.##..###@@@@@@....#.#.#.#@..##......@@@@@@@@@#.#.#...##@@@@@@@@@@@@@@######
#####.#...#.##.##.###...#####.#..#@#...#..#.##@#......#..@....#.......##..##@.#....#.#.##.######
#####.#####.#.#...#..#####.##.####@###.#..#...@#...#.###.@.#.#..#.##..#.####@...#...#.##..######
#####.@.#.#..#.#.#.##..#.####..#..@#..##..###.#.##..###....#...##...#..#....@##..#..####..######
####.#@###...#...####..##.#....#..@.#...#.....###..#.#######.#..#.###.#..#..@.....#.#...#.######
######@#.#.########.##.##..#...###@.######..#####..##...#..#..#.....##..####@....#..#..##..#####
####..@..##.##..#...##.....###....@@@@@@@@@@@@@@@@@##.....###.#...#..##....#@#.###.#...##..#####
####.#@@@@@@@.....###...###..####.##...###..@##.##..##..####.##..#..#.#..#..@##..#..#.##.#.#####
#####..#....@######..#..#.###.##..#.#####.#.@.@@@@@@####.###..##...##.##..##@#..##.#.#.#.#.#####
####.###..##@.###..#########.....#.###.###..@#@###...#.@@@@@@@@@@#...#..#.#.@####.#..#..#..#####
####.#.#.###@##..##...##...#...#.####.#..#.#@#@.#....#.....#...#@..#..####.#@.###....###...#####
####.##...##@.###.####..##.#..#..#####.#..##@.@.....###.##......@....##.###.@..#.#...###...#####
####.#....#.@###.#..##.###...#########....##@#@#..##..#.##...##.#@@@@@@@@@@@@..##..#..#.#.######
#####...##.#@@@@@@#.#.#.##.##.##.....#...#..@#@@.....##..#.#####.@..........#..#####..#.#..#####
####.##.#..#...##.#.#####..###..#####..#####@#@@..##.##.#.#######@#.##...#.##.##.....##.#.######
####.#.##..#....##.#.###..#.#.#####.##...##.@.@@#...#.##..#.##..#@...#.##.##..##..#.###.#@######
####.##..##....#####.##..###...#@@@@@@@@@@@@@.@@#...#.#.#...####.@##...#..#.#.....#.#.#..@.#####
#####.##..#...#...#.#...####.#.#@#.#..#.###.#.@@#@@@@@@@@@@@@@@@@@..#...#.###...#..##..#.@######
####...##.....#......###..###.#.@#.####.##.#..@@.@..#######.#...#@..##.#.#.#.#....####..#@.#####
####.#..#.#.##.#...#####.#...#..@.#.##..###.##@@#@###.#.......##.@.#.####....####..#.@..#@.#####
####.####..##.....##...#######..@..####@@@@@@@@@.@###.#..##...#@@@@@@@@@@@@#..#..##..@##.@.#####
######...#..#.####..#..#.##...##@.#...#.....#..#.@###.#####.##.@.@.##.....@@.....##..@.#.@######
####...###.####..#..#######.##.#@.##@#...#..#.#.#@##.#.#.##@@@@@@@@@@@@@@@@@##....###@@@@@.#####
#####......##.##....#...#..#..#.@..#@###.#..#..#.@#...###.#.@#@@@@....##..#.###.#..##.##########
#####.......#.#......#..##.#..##@...@..##..#...#.@.#.##...#.@#.@.##.##..###.#.###..##...#.######
#####.##.##......###..##.###.###@#..@######.#..#.@..#.#..#..@#.@.#..#....@@@@@@@@@#.##.#..######
#####...#.#..#....##.#..##..#.##@#.#@..##.######.@##...#..#.@.###.#...#.###.....#.....#..#######
######..######.#..#####..###.#.#@..#@.#..#.#.#...@##..#.##..@.#...#...#..#..#.#...##.###########
######.#.#.#..#..#.##.##.##.#...@.#.@......##.#.#@..##...###@.....##.#..##..###.....#.##########
#######..##..##.#..#.......#.#.#@#..##.##.###.#.#@######..#.@#..#.....#..#....##....############
#######.#.####....##.#....#.....@##...###.###...#@#.#.#.#...@#...#.#.#.@#..#.#..#.#.##..########
#######....##..##..#.###.##.#...@.#.#.#.#.###.#.#@##..#..#.#@...##.#@@@@###...#....#.#..########
########.##..#.#.####...#####...##..###...#...#.#@#..##.#@..@...##..@#.@...##...###.#.##########
########..####.#....######.###..##.#.##@@@@@@@@@@@.#.#.##@.#@...@...@..@#...######...###########
#########.#...#.#..##.##..#..##.###.##..###.###.##.......@#.@...@..#@#.@#...#..###.#.###########
##########.#..#....####....##.######.#.#......###.#.#####@@@@@@@@@@@@@.@#..#...#....############
##############..#..##..#####.###...###.##....@@@@@@@@@@@@@@@@###@##.#@.@####.....##..###########
#############...#.##..####...##..###..###.#..##..#......#....#..@#...@.@.#.#.#..#..#############
############..###.####..##.#..#@@@@@@##..#.####.##.#..###..#...#@####@#@.#.#.#.#.###############
#################.##...#..###..@.....#..##.###.#....####..##..##@#.#.@.@#..##...#.##############
##############..#.##.#.##...#..@..#..##.#.##...#.#.##..###.#.##.@..##@#@..###.#.################
##################.#..#.##.##@@@...####.##...#..#.####..##...#..@#.##@.@.##.#.#.################
##############....#.##..###....###...........###.#..##....#..#.#@.###@#@##...#..################
#################.#.#.......#.##..#...#..###.##.##.#.##...#.##.#@@@@@@@@@@@@@@@@################
#################..########..#####.#.####...#.#.#.###..##..#..#..##.#@.@#.#...##################
#################.....#.#....#..####.....##.#####....###.#..#.#.#...#@@@....#.##################
###################...##...###.#.###.....#.#..#......#.####..#......#.##...#.###################
####################.#.##.#.#####..##..#..##..##...#.#..######.#.###...#.#######################
#####################...#####.#.#.....#.#..##.##......#...#...##..#.#.##.#######################
#######################.######.#.##......##..#.#.#.##..#.###.##...#.#.##.#######################
#########################..#.#.##.#.....##.#.#.#...##...#..##...#..#.###########################
#########################.#.#.#.#.#####.###.#.#.#.#######.##..####..############################
###########################.##.###.#..###.######.##.#####..#..#..#..############################
################################.#..#...#######.###...########.#################################
################################.#..###...#.#.##.#.#####.##...##################################
##################################.#...##..##...##.##......#####################################
######################################..#.....#.#...###.########################################
################################################################################################
################################################################################################
################################################################################################
################################################################################################