Start = (48, 48) , End = [44 85]
=== Checkpoints ===
Checkpoint 1: Side A, Position [28 34]
Checkpoint 2: Side A, Position [35 32]
Checkpoint 3: Side B, Position [26 15]
Checkpoint 4: Side A, Position [20 33]
Checkpoint 5: Side B, Position [31 17]
Checkpoint 6: Side A, Position (60, 89)
Checkpoint 7: Side A, Position [46 51]

=== Side A ===
################################################################################################
################################################################################################
################################################################################################
################################################################################################
######################################...##.##.##...#.##########################################
##################################..#..#.#.#.#.###.#.#.###..####################################
##################################..#...#.######.#...###.#...#.#################################
#############################...###.##.#..#.##.#####.##.#.###..#..##############################
############################...#.###..#####.##..#.#......####..#..##############################
#########################.#..#####..##.##.##.#.##..#.#.###...#...####.##########################
########################.####.##..##.######.#.#.##..#...#.#..####.#.##.#########################
#######################.##.#####.#.#.#...#..######.#..#####......#####.#########################
#####################.#.#.##.....##.######...#..##...##.#.###..#...#..#.########################
#####################....#.##.#.##...##..##...###.#######...######...###..######################
###################.#..######...####.##..###.#....#.####..#.##..#.##.####..#####################
####################.#...##.#...##.####.####...#.##.#..#.#.#####.##...#..###.###################
################.##..#.#...###.########....##....#.#.####.##.###..#####.#.#.#.##################
####################...#.####.#.##.#.#.#.....#.#...###.....###..###...#...#.#..@################
##############..##....#.##..#..#..##..#..#######...####.#.....#.####.#...#.#..#@.###############
################..##....#####.##.##...#.#...#..##....###.#.#...#########..#####@.###############
###############.#...#####.##.#.#.#...####.#.#.#.###.....###.#.#.##.#######.#.#.@.###############
###############.....##.####..#..#.....###.##..##..#..##.#.###.##...####.######.@.#.#############
#############..#.....#..#...#.#..###@@@@@@@@@@@@@@@.....#.##.##.....@@@@@@@@@@@@#.#.############
##############.....##..##....#.#.###.###..#.....##@##.##.##.##.#..##@..##....#...###############
###########.###.#....#.#.......@@@@@@@@@@@@@@@##.#@.#....#.....#....@###.###.#...###.###########
################.##..###.#...#.@#..##.#.#.#...#.#.@.###.#..###....##@..#.###.####.#...##########
##########....##.##....#...#.##@..#..####.#.#..#..@.##.###.#...#.###...#.#.##.#.......##########
########..####.#..###..#@@@@@@@@@@@@@@@@..####..##@###.#.###....#.#.####.##...#.....#.##########
########..#.#.....##.##.@#..#..###..####.###......@.###.#@..###..#....#.##.##..###..##.#########
#######.....##.#..##.#.#@#...###.##.#.#.#####..###@#.#...@##...@#........##..#.##.#####.########
##########..###.#.......@...##.#....#..##...#.##.#@##..##@..##.@.#..##...####.#.#..##.##########
#######..#..#.##..#...###.#..#........#.#.####..##@..#...@#.##.@.#.###....#..#.##.#..##.########
########...#####.#.#.##.#.....###..#####.###....##@.#.#.#@#@.##@.##...#.#....#.###.#.#.#.#######
######..###...#...##..#.###@@@@@@@@@@@@@@@.#..####@..###.@.@#..@#..#...#..###.....#.#.##.#######
#######.##..##...#.#.#..####..####....###@####.##.@#..##.@.@.##@##.#####.#.#.......##.....######
######.####.#...#.#..##..#.##@@@@@@@@@@@@@#.....##@@@@@@@@@@@@@@@.#.#.#.###.####.@@@@@@@@@######
######.#####.###.###..###########.#..####@.#######.#..#..@.@#.##@######.#.##..###...#.##########
######.##.#.#.###.#.#..###.#.#..#.#######@#..#..###@@@@@@@@@@@@.@.##.#.#....##..#.#.#..#.#######
####.##...###.##.....##.##.#..##...#@.#.#@.###@@@@@@@@@@@@@@...#@#..#......###.....##.#.########
####.##.#.##..#.####.##.####..##.#.#@.##.@###.@####@#..#.@.@###.@.#..######@....###.#.##.#.#####
####.#...#.###.##.##..#..#..##..####@@@@.@.###@.#.#@....#@#@.#..@##.####.##@..#.#..#.##...######
####..#..###.#...#####.#...########.....#@@@@@@@@@@@....#@#@#.#.@####..###.@..#.#####@####.#####
####.#.#.####..####....#.####....#....##.@##.##.#..@##...@#@.#..@#.####.#.#@.....#..#@#.##.#####
####.########...#.#.#...##..#..#...#.#..#@####@@@@@@@@@@@@@@#.#.@...#......@@@@@#...#@#..#######
######..#.....##......###..#..#.###..##..@.#..@#.##@###@@@.#..##@.#.#....###...@..#..@...#.#####
####.#.#.##..#.##.#.#.#....#...##..###...@@@@@@#.#.@.#.#.##.#..#@#.######..##.#@.#...#...@######
####....#####.....#....##...#.#.########.###.#@#...@@@@@@@#...##@####...#...#..@..#...#..@.#####
###.#.##..##.#..#@@@@@@@@@@@@@@......#.###.###@#####...#.@#.##..@..#######.##.#@.##.###.#@.#####
####.#.#.###.#.##.###..###..##@#.#.######..#.#@###.##..#.@####.#@#.##..#.##.###@.#..###.#@.#####
####...#...#..##.....##.##...#@####.##.###.#.#@.##...####@##..##@###.#.#.......@@@@@#####@######
####..#.#.##..#.###.#.##...#..@....###.#...###@.###.##.#.@####.##.##....#..#...###.@..#..@######
####..#.##...##...###...######@#....#.#.###..#@##.#.##...@#..#.#.#....####.....##..@#.#..@.#####
####.##.#####..##..##...#.#..#@###.###..#.###.@...#@@@@@@@@@@@@@@#.#.##..#..#..#.##@##..#@######
####.###..#..##.#.######..#..#@##..##..#..####@##.####...@...##.##....##.##.#.#.#..@####.@######
######.....###.#.#######.####.@..##.#.######@#@.####.##..@#.#@.##.##....#....###...@.#..#@.#####
##########...##.....#.#####..#@#..##.#.#.#..@.@..#.#.#...@#..@..#..#.#....###.#....@@@@@@@######
#####.#.##.#...##..##.##..##.#@.......#.#..#@.@#..#.#....@...@.###.#.##...########.#.....@######
######..#.....#.####...###..#.@#####..#....#@#@###.##.#.#@#.#@#..#....#.....###.#..##....@######
#####..#.#..#.##.....#..#.#...@#####.##.....@.@@@@@@@@@@#@...@..##.##.##..#....##.####..#@######
######..##.#.##.#.#.#.##....#.@.#.#.#.#.#..#@#####..###@##...@####..#.........#..#...####@######
######.##.######.###.##.#.##.#@##.#...##....@##.###.##.@###.#@##.###.#.##@@@@@@@@@@@@@@@@@######
######.##..###...##...#.#.####@##.##....#.##@.#.###....@..#.#@#.#.###.#....##......#.#.#########
#######..####.###....#.##.#.#@@@@@@@@@@@@@@@@###.###.#.@..#.#@#####.##.##.#....#..#####.########
#######.#....#.#......#.#...#.@####.#..##.#.@##.####.##@#....@.#...#####..#..###...#.##.########
#########.....#########.#........#....#.#.#.@...######.@##..#@.##..###.......###.##..#.#########
########.###.##.####.#####..##..####.#.#..##@@@@@@@@...@...##@###.##.#...#..##...##.###.########
##########..#.#......###.#..#.##.####....#..@###.##@#..@@@@@@@@@@@@@@@@@########.##.##.#########
###########..#.#.......###.##.#...@...#.....@...#.#@.#.#..#.####..#.....#.##..#.#.#..#.#########
#########..##.#.#.####.#..#.#####.@.######.#@..##.#@######.#...#...#.##.#####.###.....##########
##########.###.#.#..#.#..###.####.@#.#.####.@.#.#..@...##.....##....#.#....######.....##########
##########.####.#.#..............#@.......#.@.#####@......#.#.####..#.#..##.##..#.#..###########
###########..####.....#..#.####..#@......#.#@.#..##@..#.#...###...#.##.#..#..#.##.##############
############.#..#...#.###.###.##.#@.....#.##@..###.@#........#..#....##.##..#...#...############
################...##....####.####@#...#.###@#.####@#.....#.##.###.##...#.##.##....#############
##############..##.#######..#...##@@@@......@......@#.....#.#....#.#.##.#..###.#################
##############...##.#...##.#.##..@....##.##.#..#...@...#..#.......##.#.#...#.##.################
##############.###....####.#.@@@@@#.....#.#.#.##.#.@...#..#........#..#.###..##.################
###############..#.##..##..###.#..####...######....@#..##..#.##.###...###.#.....################
##################.#.##..#.#.....##....#.#####..#...#...#.#...#.#####.##.#...###################
#################.#.##.##..######.#.#..#....#..#.#..######..#.##.##..##.##.#####################
##################.#.###....####.###......#.#..####.#.#.##.#..##.##.#..#.##..###################
######################.#......#..######...#..###.#.#.#.............#.#.#.#.#####################
######################.###...##.#..#.##....#.####.....##.##.#...#.#..###########################
########################.##.......#.....#..#...##..#####..#.#.###.#..#.#########################
#########################..#...#..##.#.#.####.#.##.#.##.###...##...###.#########################
###########################..##..#.##.....##..#.###.#..###.......#.#..##########################
###########################.#....#..#..##.#.#.######.##...#..##.##.#############################
#############################.#...#.#...#...###.#.#..##...#...##################################
#################################.#.###.#.....#.....#.##....#.##################################
#####################################..###.#..###########.######################################
######################################...#....##....#.#..#######################################
###############################################.################################################
################################################################################################
################################################################################################
################################################################################################
##############################################################################################..

=== Side B ===
################################################################################################
################################################################################################
################################################################################################
################################################################################################
########################################.###...#.#.....#..######################################
#####################################......##.##...##..##...#.##################################
##################################...##.#####.#.##.#.#...###..#.################################
#################################.########...###.#######...#..#.################################
############################..#..#..#..#####.##.######.###..#.###.##.###########################
############################..####..##.#######.#.#.#.###.#####.#.#.#.#.#########################
###########################.#..#...##..#...##...#.#.#.##.....#.##.#.#..#########################
#######################.##.#.#...##.###.#..##.#.#.#..##......##.#.######.#######################
#######################.##.#.#..##...#...#......##.##..#.#.....#.#.#####...#####################
#######################.#...###.#.######..#.#...##..##..#..##..#####.#.##.#.####################
###################.#...##.#......#..####.#......#..#.#.....###.#.###...##...###################
##################.#....@@@#...#.#.#..#.###....#####.##.....####..#....#.#.....#################
##################...#.#@.@#.##..#..#..##..###.#.#.#...####.#.#####..########..#################
################@@@@@@@@@@@@@@@@#.##.#...##.#.##.##.###..#...#..##.#.......#.#.#################
################..#...##@#@###.@#.#..#....##..#.###...........###....###..##.#....##############
################.#.#.##.@.@##.#@..#...##..####.#..#...##.####...@@@##.##.#..#.##################
################.#.###..@#@##..@.##.#.###..##.#.#...##.#.##..#..@..#...##.#.##.#..##############
##############.#...##..#@.@.#.#@##..##..####....#.###.##..#.....@..###..#...##.#################
###############.#.#.#.#.@#@####@#...#..###..#.##.####.#..##@@@@@@#..#.##..####.###..############
#############..#..#.#.#.@.@...#@..#....#......#..##..#.###..###..##...####..##.#...#############
###########..##.....####@.@#.##@###@@@@@@@@@@@@@@@@....##.###...###.#####..##..#..##############
############....#...#..#@.@@@@@@@@@@@@@#####.#.###......#.#.######.##....####....#..#.##########
###########.#.###..#...#@.#@#..@...@.#@.......##.###.###..##.###.##..#..##.##..#.#...#.#########
###########...######...#@..@...@...@#.@##.#.#.@@@@@@@@@@@##.#.##..###.######....#.####..########
##########.#.###...##...@.#@..##...@..@#.##..#@#.#...#...###..##...#####...####.#.#..##.########
########..#.#....#...###@@@@#.##...@#.#..#..##@#.#.###.#.#.#.#.@...#.##.###.#..##..##....#######
########..##.#.#..#.#..#@.#.#.#...#@...#.#.#.#@#...###.###...##@.....#....#.##....####.#.#######
############....##....#..#.....#..#@.#..######@#.#.###.##.##..#@#.#.#.......#..#.##..##..#######
##########.#.....###..##..#.##.....@###...##..@#.#.##......@.#.@...#.##.##.##.#..#..#.#.#.######
###########.##...#.#..#..#...#...#.@..##.#..##@...#.#.#..#.@#..@#.#.###..#####..#.######..######
#######..#.....#.....###.#...#.###.@.#..#...##@.######.##..@#.#@##.#..##..#.##....#..#.#...#####
######..#.##.#@@@@@@@@@....#..#.@.#@..#..#.#..@.#..#.######@..#@###.###.##..###......##.##.#####
######.#...##..###.#.###..##.##.@.#@.#...##.#.@.#...#..##..@...@##..#.##..#......#.#.......#####
##########.##..#.###.#..##....@@@@#@.#.###...#@.#..#..#.###@#..@.#..#..#...#....##.##......#####
#####.@@@@@###....##@@@@@@@@@@@@@@@@@##.#.#.##@#.#.#..#...#@##.@#.##.#######..#..####.###...####
######@.#.@..##.....@@.....##.@.@.##.#####.###@.#..#.....#...#.@##...##.#..#..####.#..#...######
#####.@.##@..##..#..#@@@@@@@@@@@@#...##..#.###@.@@@@@@@@@####..@..#######...##.....##..####.####
#####.@#..@.#..####....####.#.@.##.......#.###@#@@##.###..##.#.@..#...#.#####...#.##.#.#..#.####
#####.@#..####....#.#.#.#.##..@#...#.#######..@.@@..#.##.####.#@.#.###..###......#.....##...####
######@.#..##..#...###.#...#..@@@@@@@@@@@@@@@@@#@@.#.###.#..#.#@#.#.####...#.#...#...#..##.#####
#####.@..#.#.#.....#.#..#...##@.####...#.#.#...#@@.@@@@@@@@@@@@@#...###..##.#####....##..##.####
######@#.###.#..##..##.##.#...@#..##.#..##.#...#@@.@.##...##.#####.#.#..###.#.##....#..##.#.####
######.#.##.....##.##.#...##.#@#######.#.##.##..@@#@#####..#####..###..#####.#.##...#..#.##.####
#####..#.#..#####..#..........@.#####.#..##.....@@#@..#...#.....##.##.##.#.#.#@@@@@@#.##...#####
######.#.#..#..##..@@@@@@@@@@@@#.##...##.#..##..#@#@##....#########...###.##..#.###@.#....#.####
#####...###...#.#..@.###.##....@......##.###.....@.@##..#.#####..#..#.##..####.###.@##...##.####
#####...###....###.@#.####..#..@#...#.....#....#.@#@#.#..#.####.#...#...##...##..##@###.#.#.####
#####..#..#..#.####@.#.#..#...#@@@@@@@@@@.#...###@#@..###.###.#.....#########..###.@##..###.####
#####.#.#.#.#.##..#@##..##.##...##..###.####@@@@@@.@.#.#####.#..##.###.#..#..######@....#..#####
#####.#.##.#..#..##@..#..#.#..#..##.####..##..##.##@..###...##.####..###...###.....@@@@@@@#.####
#####..##...#.###.#@#....##..#...#.###.....##@@@@@@@@@@@@@@@@@....###.....##...#..##.##..@..####
#####..##..#..#....@####..##.....#..#..#...##..#####..######.@###...#..##.##.########.#.#@######
######.#...#.#.....@..#..#.###.#..#.#######.#..###.....#...#.@..#....#.##..####...#...###@#.####
######..####..#..##@....#..#...##...#....###..##.#.###..##..#@..#..####.#..##.#.#.#..#.#.@.#####
######..##.#...#...@####.#..##.#..#.#.@.###.#...#@...#..#.###@####.##.#####..#...#.#.#####.#####
######.##.#.#....#.@##..##.......#....@..#......#@##.#..#...#@#..#.#####...###.##.##.#...#.#####
######@@@@@@@@@@@@@@##...#.#.#@@@@@@@@@......##..@#.#.#.#....@@@@@@###..##.#####.#..#....#.#####
#########..#.#.#.##.####.#....@..#..####...#...#.@##.#.#..##.@@.###...#.#.###..###...#..#.######
#######...#....##.#..#.#.#....@..#.##.#...####..#@......##.##@@#.#@@@#..#....####.#.#..#.#######
########.......#......#.......@#.#.#.#.#####.###.@###....##..@@###..###.#.###.#####.##.#########
########.##....########...#####.##...#.#.#...##.#@##..#..#.##@@#..#.##.#.##....###....#..#######
#########.######..##..#...#...#.####..#..#.##.#.#@#...#.##...@@.#.#...##.#.###...#####..########
#########..#..#..#......#.##.##..#@######.##..###@..#.#.#.###@@##.#...#....#.#...#....#.########
##########....###.#.#..###...#....@...#..######.#@###...###..@@.#.####..#.#.#..#.....##.########
##########.....#.#...####.##....##@#.##.#..####..@#..#####.##.@#.#..#..#.#.#..###.##.#.#########
#############.#..##.#....#.#.#....@...#..#####.##@######.#...#@...###..#####.#....##..##########
############.##..#.##.##.......##.##...#.#.#..##.@...##.#..###@###.##..##.##...#......##########
############.##...#.##...#.#####.#####.....#..###@###..###....@####.#.#.#...##...###############
############...#.....##..##..##..#.#.##.#..#.#.##@..#....#....@#.#..######.####.##.#############
###############..#.....#...##.##..##.....#.####..@##...#....#.@#..###.....#.#.#...#.############
##############.###.....#..##....###.#..##....#..#@@@@@@@@@@#.#@.###..#.###....##..##############
###############.#........#.#.#.##.......#.####.###.@#.......#.@.#....#.######.....##############
################.###..#...#.#.#.#...#..#.##...##..#@###......#......#..#.#..##..#.##############
###################.#..#.#...#..###....##.##..####.@......###..#..#.##.##..####..###############
####################...#.#.##.#####.....#....###..###.##.##.#.#......##.##...#..################
###################.##.##.#.#....#......##....#...##..####......#...##.##.#..#.#################
###################...#.###...#.#.##....#.###..#..#...##.########...##.#.##...##################
######################.#.##...####.#..####..###.##.#..##..###.#.##.#.###..######################
######################.#..##.......##.#.........#####.####..#.#..#..##..#..#####################
#######################..##...####.#.......####.##..#...##.#.##..#..#.#.########################
##########################.####.##.###..#.##.##......#...#.##..#...###..########################
##########################...######..#.#....###.###...#######..##...##.#########################
############################.##.#...#....###..#..##.###..#######.###.###########################
###############################..####.###.####.....#.#...#.#.###.#.#############################
#################################.#.##.########....###....####..################################
###################################..##....#.##.#...###.....####################################
########################################.##.####......##..######################################
################################################.###############################################
################################################################################################
################################################################################################
################################################################################################
##############################################################################################..